id,user_id,transaction_type,purchase_date,processed_at,gross_transaction_amount,discount_amount,net_transaction_amount,shop_id
2676,9854,0,2023-03-13 13:32:46,2023-03-13,3097,41,3056,A85
20396,9910,0,2023-03-21 09:53:15,2023-03-21,917,82,835,A49
47074,1952,0,2023-03-24 12:48:15,2023-03-24,1820,54,1766,B68
81023,7402,0,2023-03-29 06:11:11,2023-03-29,9867,56,9811,A03
5448,6693,0,2023-03-25 07:21:58,2023-03-25,7164,49,7115,A03
37835,7498,0,2023-03-02 01:17:51,2023-03-02,7594,48,7546,A65
2458,7035,0,2023-03-23 23:05:00,2023-03-23,2208,94,2114,B82
14289,8719,0,2023-02-28 08:40:51,2023-02-28,5102,47,5055,B56
92258,9153,0,2023-03-29 00:37:12,2023-03-29,8446,91,8355,A63
50941,6399,0,2023-03-06 14:48:54,2023-03-06,3632,65,3567,B73
50637,7696,0,2023-02-28 14:36:04,2023-02-28,465,87,378,A57
17300,7585,0,2023-03-09 07:27:41,2023-03-09,4406,41,4365,A47
40342,3887,1,2023-03-22 00:22:44,2023-03-22,1628,58,1570,A40
13322,3783,0,2023-03-11 21:02:44,2023-03-11,3208,64,3144,B58
60673,9165,0,2023-03-19 01:30:49,2023-03-19,9407,68,9339,A93
12451,8269,0,2023-03-08 08:02:17,2023-03-08,7523,42,7481,A55
49121,4418,0,2023-03-15 14:14:49,2023-03-15,7686,49,7637,B08
83447,1486,0,2023-03-07 21:14:58,2023-03-07,5332,61,5271,A33
29860,6086,0,2023-03-29 18:44:43,2023-03-29,1993,13,1980,B54
18232,1788,0,2023-03-28 18:09:07,2023-03-28,287,2,285,A19
43683,8417,0,2023-03-04 19:59:23,2023-03-04,8504,78,8426,A82
98298,3587,0,2023-03-27 19:23:20,2023-03-27,5302,69,5233,B65
46715,4849,0,2023-03-11 04:11:33,2023-03-11,1116,8,1108,A72
60240,7311,0,2023-03-07 10:32:12,2023-03-07,5413,95,5318,B79
69723,2308,0,2023-03-03 22:16:54,2023-03-03,1046,64,982,A42
50305,1506,0,2023-03-11 22:13:05,2023-03-11,3824,23,3801,B60
49813,7790,0,2023-03-08 19:06:26,2023-03-08,4691,69,4622,B90
741,3698,0,2023-03-08 09:27:58,2023-03-08,4304,99,4205,A33
13209,5309,0,2023-03-05 12:14:41,2023-03-05,7378,76,7302,A26
3658,5030,0,2023-03-20 20:55:46,2023-03-20,4632,62,4570,B46
30739,4360,0,2023-03-07 14:52:28,2023-03-07,6354,42,6312,A93
30123,1406,0,2023-03-18 07:31:28,2023-03-18,2303,50,2253,A52
1330,6888,0,2023-03-25 16:12:03,2023-03-25,9443,53,9390,B03
22067,9880,0,2023-03-14 02:02:08,2023-03-14,7994,6,7988,A76
95288,4739,0,2023-03-18 14:48:04,2023-03-18,1300,7,1293,A65
180,4261,0,2023-03-29 02:29:32,2023-03-29,607,47,560,A22
56739,8783,0,2023-03-04 17:34:37,2023-03-04,6884,34,6850,B56
20345,7250,0,2023-03-05 23:00:00,2023-03-05,4525,76,4449,B44
45860,8789,0,2023-03-01 12:41:19,2023-03-01,4444,18,4426,A85
64685,4005,0,2023-03-17 03:41:54,2023-03-17,854,0,854,A30
91585,8011,0,2023-03-19 05:04:36,2023-03-19,7987,29,7958,A26
65437,8849,0,2023-03-27 05:25:54,2023-03-27,8796,56,8740,A15
8646,9808,0,2023-03-26 00:16:55,2023-03-26,5571,23,5548,B64
89481,1442,0,2023-03-08 07:25:12,2023-03-08,830,98,732,B90
1198,6338,0,2023-03-28 14:09:32,2023-03-28,9130,61,9069,B21
77443,6212,0,2023-03-27 02:34:12,2023-03-27,9845,1,9844,B32
52340,9653,0,2023-03-04 10:11:48,2023-03-04,974,89,885,A26
32614,5125,0,2023-03-05 21:52:53,2023-03-05,1417,44,1373,B80
76031,5993,0,2023-03-07 21:03:43,2023-03-07,2341,77,2264,A15
29013,4328,0,2023-03-13 01:55:52,2023-03-13,8767,28,8739,A98
75904,4249,0,2023-03-22 22:23:47,2023-03-22,7302,50,7252,A50
97137,8481,0,2023-03-05 23:48:55,2023-03-05,6488,6,6482,B46
90823,8471,0,2023-03-09 12:21:23,2023-03-09,3811,59,3752,B66
79943,4851,0,2023-03-29 07:43:32,2023-03-29,6805,82,6723,A85
71873,2537,0,2023-03-16 05:29:17,2023-03-16,8566,19,8547,A13
32162,3261,0,2023-03-10 11:54:56,2023-03-10,7924,12,7912,B17
51122,2290,0,2023-02-28 10:04:38,2023-02-28,696,8,688,B73
54182,3979,0,2023-03-15 23:30:08,2023-03-15,4378,28,4350,B82
39168,7696,1,2023-03-26 08:35:54,2023-03-26,7300,49,7251,B03
93735,6517,0,2023-03-28 13:34:09,2023-03-28,3347,32,3315,B49
63099,2196,0,2023-03-02 12:50:34,2023-03-02,8714,42,8672,B55
88408,8312,1,2023-03-12 23:47:42,2023-03-12,613,30,583,B65
48665,6406,0,2023-03-04 17:31:42,2023-03-04,4400,1,4399,A12
54980,7234,1,2023-03-02 10:49:17,2023-03-02,5550,56,5494,B12
88131,3197,0,2023-03-01 15:29:42,2023-03-01,2823,93,2730,A21
49537,2614,0,2023-03-20 15:01:40,2023-03-20,9341,14,9327,A52
25659,2837,0,2023-03-07 01:18:41,2023-03-07,1546,17,1529,A59
80410,1351,0,2023-03-10 09:13:34,2023-03-10,6046,88,5958,B02
67997,4231,1,2023-03-27 03:40:30,2023-03-27,5146,24,5122,A04
29136,6536,0,2023-03-14 11:41:46,2023-03-14,8658,77,8581,B48
37514,1408,0,2023-03-19 20:12:45,2023-03-19,896,34,862,B21
41931,9231,0,2023-03-14 06:54:06,2023-03-14,4122,92,4030,A65
43875,2085,0,2023-03-19 01:34:58,2023-03-19,495,42,453,B46
48674,5925,0,2023-03-13 06:47:52,2023-03-13,1961,12,1949,A94
80068,6693,0,2023-03-15 14:13:03,2023-03-15,176,67,109,A87
82897,8191,0,2023-03-14 04:43:14,2023-03-14,3581,19,3562,A31
52095,8391,0,2023-03-14 18:24:21,2023-03-14,4926,44,4882,A63
87090,6152,0,2023-03-24 06:31:56,2023-03-24,1180,21,1159,A19
72805,6837,0,2023-03-04 23:08:42,2023-03-04,1827,90,1737,B07
2216,3570,0,2023-03-24 12:32:39,2023-03-24,3517,7,3510,A66
59786,3724,0,2023-03-18 16:17:07,2023-03-18,9665,33,9632,A84
37153,5800,1,2023-03-06 17:21:26,2023-03-06,5605,84,5521,A31
85867,3691,0,2023-03-16 19:33:56,2023-03-16,669,30,639,A29
55855,4169,0,2023-03-27 11:33:19,2023-03-27,748,5,743,B65
9060,7161,0,2023-03-14 11:35:10,2023-03-14,9220,97,9123,B67
79713,8890,0,2023-03-01 23:19:15,2023-03-01,7291,56,7235,A83
23484,7702,0,2023-03-23 18:05:21,2023-03-23,2750,45,2705,B45
19794,6922,0,2023-03-12 12:04:47,2023-03-12,9329,23,9306,A68
74347,9881,0,2023-02-27 22:45:19,2023-02-27,6439,60,6379,B46
54526,9313,0,2023-03-29 01:54:32,2023-03-29,3243,85,3158,A54
71610,4072,0,2023-03-13 22:01:25,2023-03-13,2064,11,2053,A41
13231,9534,0,2023-03-07 05:43:34,2023-03-07,7422,97,7325,A02
19587,5727,0,2023-03-19 14:21:12,2023-03-19,1572,23,1549,A42
48688,2462,0,2023-03-14 08:23:52,2023-03-14,1849,38,1811,B49
66737,6788,0,2023-03-20 15:15:09,2023-03-20,9168,28,9140,B48
28220,3995,0,2023-03-19 00:15:40,2023-03-19,3435,81,3354,A17
78907,1565,0,2023-03-28 08:32:48,2023-03-28,4316,83,4233,B48
90913,8603,0,2023-03-06 05:08:32,2023-03-06,7296,29,7267,A66
22412,3628,0,2023-03-07 14:35:25,2023-03-07,2291,45,2246,A33
70797,9497,0,2023-03-27 02:09:04,2023-03-27,4275,65,4210,A15
74868,9550,0,2023-03-17 15:35:51,2023-03-17,1003,71,932,B09
19662,6892,0,2023-03-02 04:10:53,2023-03-02,9620,38,9582,A44
98632,7609,0,2023-03-15 18:33:40,2023-03-15,1482,55,1427,A16
98981,2982,0,2023-03-04 19:12:06,2023-03-04,9643,61,9582,A62
75581,5496,0,2023-03-06 03:04:53,2023-03-06,7742,0,7742,B47
26540,7037,0,2023-03-19 23:58:06,2023-03-19,844,56,788,B72
45578,9455,0,2023-03-12 20:12:23,2023-03-12,7496,93,7403,A98
50016,1691,0,2023-03-25 00:21:36,2023-03-25,3467,67,3400,A13
76119,6628,0,2023-03-06 12:19:37,2023-03-06,6734,81,6653,A16
34337,9694,0,2023-03-02 15:27:33,2023-03-02,6279,10,6269,B69
87884,4305,0,2023-03-11 05:06:04,2023-03-11,8214,56,8158,A39
52828,1518,0,2023-03-01 18:14:32,2023-03-01,1097,27,1070,A92
664,7203,1,2023-03-04 05:40:49,2023-03-04,8820,98,8722,A54
64556,7472,0,2023-03-23 04:14:32,2023-03-23,4632,50,4582,A32
83226,7062,0,2023-03-28 19:00:35,2023-03-28,4631,92,4539,B09
62150,3139,0,2023-03-26 00:24:03,2023-03-26,7667,93,7574,A55
72523,7038,0,2023-03-02 19:48:17,2023-03-02,7018,53,6965,B67
6497,4293,0,2023-03-01 02:56:52,2023-03-01,2389,63,2326,B21
77437,7878,0,2023-03-29 01:30:23,2023-03-29,1031,12,1019,B24
93741,7904,0,2023-03-05 13:16:32,2023-03-05,4780,28,4752,B27
55934,8208,0,2023-03-10 20:50:28,2023-03-10,7656,2,7654,A49
36769,5517,0,2023-03-24 17:47:20,2023-03-24,1148,70,1078,B69
71254,9856,0,2023-03-17 11:05:43,2023-03-17,940,39,901,A80
73196,9430,0,2023-03-19 08:16:49,2023-03-19,5446,42,5404,A49
47342,8513,0,2023-03-03 18:01:57,2023-03-03,6863,61,6802,A80
29589,4056,0,2023-03-03 10:38:31,2023-03-03,8889,50,8839,B65
71650,7931,0,2023-03-13 12:01:48,2023-03-13,1783,89,1694,A15
86666,9038,0,2023-03-05 14:49:28,2023-03-05,5314,0,5314,B75
77465,6569,0,2023-03-27 09:54:55,2023-03-27,4054,94,3960,B54
99987,6339,0,2023-03-21 07:01:46,2023-03-21,7067,47,7020,B68
25485,3575,0,2023-03-15 18:44:58,2023-03-15,7487,28,7459,B86
39647,5690,0,2023-03-03 12:44:22,2023-03-03,2425,68,2357,B04
45953,8087,0,2023-03-24 17:05:56,2023-03-24,4359,69,4290,B72
37463,1483,0,2023-03-10 00:11:42,2023-03-10,771,5,766,A99
18845,8684,0,2023-03-14 16:02:57,2023-03-14,2973,36,2937,B75
44893,6714,1,2023-03-01 11:27:15,2023-03-01,6562,57,6505,A14
31602,6934,0,2023-03-19 04:46:07,2023-03-19,2340,43,2297,B27
91259,4458,0,2023-03-08 04:16:40,2023-03-08,7136,43,7093,A32
34555,9616,0,2023-03-15 14:46:52,2023-03-15,3926,97,3829,B69
35509,3872,0,2023-03-22 05:05:32,2023-03-22,1070,76,994,B80
36778,1093,0,2023-03-16 15:01:15,2023-03-16,9640,74,9566,A44
63114,3394,0,2023-03-02 06:31:59,2023-03-02,8162,52,8110,A46
75955,2014,0,2023-02-27 20:56:56,2023-02-27,9244,99,9145,B79
8473,4021,0,2023-03-22 20:25:44,2023-03-22,4927,53,4874,B78
32029,4733,0,2023-03-22 18:32:55,2023-03-22,1335,78,1257,B84
1992,9485,0,2023-03-05 23:33:16,2023-03-05,677,29,648,A79
89683,7404,0,2023-03-10 08:42:35,2023-03-10,7778,12,7766,A12
33096,7998,0,2023-03-22 14:24:44,2023-03-22,3277,87,3190,B76
14886,1606,0,2023-03-26 18:20:29,2023-03-26,6817,8,6809,B17
75898,5431,0,2023-03-18 02:21:54,2023-03-18,2187,70,2117,A70
82175,5222,0,2023-03-15 02:26:41,2023-03-15,9115,17,9098,A69
47402,2567,0,2023-03-16 10:19:45,2023-03-16,4380,41,4339,A63
43158,2660,0,2023-03-11 15:37:05,2023-03-11,9700,48,9652,B55
76444,1913,0,2023-03-13 22:47:41,2023-03-13,8854,86,8768,A47
66107,8297,0,2023-03-11 00:56:31,2023-03-11,4920,65,4855,B56
44706,5407,0,2023-02-28 07:50:53,2023-02-28,3767,50,3717,B16
5347,3988,0,2023-02-28 05:45:17,2023-02-28,7529,61,7468,A59
67019,9699,0,2023-03-21 20:19:30,2023-03-21,8459,27,8432,A42
98848,3427,0,2023-03-29 08:43:36,2023-03-29,7236,50,7186,B08
39641,7187,0,2023-03-15 08:55:23,2023-03-15,8164,29,8135,B84
8294,6960,0,2023-03-04 18:53:18,2023-03-04,7887,10,7877,B54
83366,4866,0,2023-03-01 01:37:37,2023-03-01,6842,91,6751,B90
31673,7909,0,2023-03-11 05:55:54,2023-03-11,9889,58,9831,A22
46918,3942,0,2023-03-04 22:00:30,2023-03-04,2998,95,2903,A75
69184,5466,0,2023-03-23 11:13:24,2023-03-23,3573,3,3570,A83
54175,1861,0,2023-03-07 06:09:32,2023-03-07,9253,87,9166,A94
56494,6254,0,2023-03-12 07:40:40,2023-03-12,4814,92,4722,B04
10351,9825,0,2023-03-24 06:28:31,2023-03-24,3646,57,3589,A19
16933,7076,0,2023-03-13 13:25:51,2023-03-13,9623,97,9526,A86
3963,5862,0,2023-03-04 22:33:03,2023-03-04,2255,2,2253,A47
72266,4741,0,2023-03-28 20:01:37,2023-03-28,3323,50,3273,B76
73834,6904,0,2023-03-08 19:35:57,2023-03-08,4067,33,4034,A62
7638,5983,0,2023-03-04 08:24:39,2023-03-04,4651,40,4611,B73
16361,2715,0,2023-03-01 12:03:34,2023-03-01,2590,61,2529,A85
56204,4604,0,2023-03-15 17:43:47,2023-03-15,9933,49,9884,A85
12681,7578,0,2023-03-28 23:33:55,2023-03-28,9373,19,9354,A61
71096,7900,0,2023-03-13 07:12:33,2023-03-13,4921,29,4892,A06
91068,9873,0,2023-03-19 18:14:51,2023-03-19,8124,67,8057,B04
80227,3893,0,2023-03-02 23:23:34,2023-03-02,8464,61,8403,B01
57801,5344,0,2023-03-11 07:05:32,2023-03-11,3542,94,3448,B85
18508,7282,0,2023-03-10 10:32:36,2023-03-10,8139,45,8094,A09
51747,2733,0,2023-03-13 11:15:13,2023-03-13,315,93,222,B45
80811,5566,0,2023-03-17 13:14:04,2023-03-17,9055,65,8990,B03
51835,4535,0,2023-03-12 10:28:23,2023-03-12,5217,42,5175,A33
27647,1069,0,2023-03-05 03:13:13,2023-03-05,3957,48,3909,B67
76464,1476,0,2023-02-28 22:48:20,2023-02-28,5101,48,5053,A88
34515,4351,0,2023-03-08 06:45:33,2023-03-08,2774,75,2699,B58
21993,7264,1,2023-03-25 04:34:29,2023-03-25,4094,92,4002,B51
49562,1915,0,2023-03-13 17:19:50,2023-03-13,8670,78,8592,A34
49770,7699,0,2023-03-20 08:06:24,2023-03-20,6489,34,6455,B50
5802,9829,0,2023-03-12 09:22:22,2023-03-12,3906,72,3834,B54
58157,6683,1,2023-03-09 13:49:18,2023-03-09,569,80,489,B16
28312,1308,0,2023-03-18 15:11:03,2023-03-18,3047,65,2982,A93
87441,6653,0,2023-03-19 00:53:52,2023-03-19,328,5,323,A82
85231,4705,0,2023-03-09 07:06:56,2023-03-09,6080,27,6053,A22
23695,3883,0,2023-03-25 12:26:17,2023-03-25,9686,55,9631,A03
26191,8692,0,2023-03-21 05:30:23,2023-03-21,9633,33,9600,A57
52968,5995,0,2023-02-28 21:24:47,2023-02-28,1345,4,1341,B64
82214,4213,0,2023-03-05 01:07:06,2023-03-05,402,16,386,A54
57727,1788,0,2023-03-12 00:30:39,2023-03-12,4730,67,4663,B88
63805,6254,0,2023-03-17 09:32:49,2023-03-17,4262,90,4172,B85
98207,5056,0,2023-03-10 07:53:03,2023-03-10,7488,47,7441,B70
54432,1697,0,2023-03-06 20:47:20,2023-03-06,4487,2,4485,A12
41561,5558,0,2023-03-28 00:34:52,2023-03-28,3620,17,3603,A65
81370,2156,0,2023-03-24 06:14:45,2023-03-24,7594,11,7583,A39
42162,3398,0,2023-03-17 12:47:14,2023-03-17,3755,68,3687,B65
61648,8196,0,2023-03-07 18:14:32,2023-03-07,8662,26,8636,A06
79508,1113,0,2023-03-05 17:47:44,2023-03-05,4314,32,4282,A67
39278,2946,0,2023-03-05 14:35:52,2023-03-05,9422,30,9392,B02
48312,5082,0,2023-03-09 20:40:38,2023-03-09,7093,68,7025,A21
85460,6421,0,2023-03-06 21:37:17,2023-03-06,5882,88,5794,B05
76577,6815,0,2023-03-21 09:59:21,2023-03-21,1413,64,1349,A10
24315,2634,0,2023-03-25 19:06:34,2023-03-25,2370,10,2360,B12
97964,7099,0,2023-03-13 10:04:30,2023-03-13,497,75,422,A21
30571,2302,0,2023-03-10 14:37:14,2023-03-10,2480,4,2476,A44
18479,9906,0,2023-03-27 10:00:52,2023-03-27,1873,37,1836,B65
90764,9706,0,2023-03-13 18:30:04,2023-03-13,9501,45,9456,B32
89029,5443,0,2023-03-14 17:48:18,2023-03-14,1777,18,1759,A55
52856,9291,0,2023-03-03 06:13:32,2023-03-03,6445,1,6444,B82
7168,5082,0,2023-03-27 16:13:42,2023-03-27,2587,43,2544,A80
2791,5878,0,2023-03-02 20:30:21,2023-03-02,2362,11,2351,B70
86262,3084,0,2023-03-19 20:57:02,2023-03-19,6601,51,6550,B01
55418,2646,0,2023-03-16 19:39:45,2023-03-16,2460,60,2400,B80
90038,6789,0,2023-03-16 03:20:09,2023-03-16,4710,99,4611,A92
56328,8653,0,2023-03-02 07:11:09,2023-03-02,5803,35,5768,A66
46691,3759,0,2023-03-08 20:55:44,2023-03-08,825,45,780,B08
43034,6853,0,2023-03-01 10:59:35,2023-03-01,922,66,856,B21
11021,6030,0,2023-03-07 05:20:42,2023-03-07,7613,41,7572,B10
43313,3168,0,2023-03-06 13:32:02,2023-03-06,4577,16,4561,A62
69334,1654,0,2023-03-15 01:04:49,2023-03-15,5821,47,5774,B03
47720,3633,0,2023-03-03 22:35:44,2023-03-03,9272,97,9175,B32
19571,5106,0,2023-03-17 15:55:11,2023-03-17,9888,82,9806,B26
89660,3994,0,2023-03-16 21:17:06,2023-03-16,5886,96,5790,A86
67359,9356,0,2023-03-06 02:29:48,2023-03-06,8214,99,8115,A87
18828,6378,0,2023-02-28 07:05:57,2023-02-28,3816,31,3785,B66
20804,1873,0,2023-02-28 14:20:52,2023-02-28,4132,44,4088,B70
59916,7582,0,2023-03-10 10:12:53,2023-03-10,3175,39,3136,A96
19889,6850,0,2023-03-07 03:59:11,2023-03-07,9243,51,9192,B18
89927,1293,0,2023-03-26 08:07:35,2023-03-26,5535,5,5530,B81
22362,3592,0,2023-03-28 13:58:51,2023-03-28,155,60,95,A96
61459,8941,0,2023-03-29 12:47:49,2023-03-29,9880,80,9800,B65
83786,3662,0,2023-03-29 02:45:42,2023-03-29,2886,98,2788,A75
17118,4612,1,2023-03-26 02:38:41,2023-03-26,6633,65,6568,A13
34350,4733,0,2023-03-24 07:04:14,2023-03-24,3019,48,2971,A19
21248,7379,0,2023-03-19 11:22:31,2023-03-19,2422,90,2332,B10
74435,5763,0,2023-03-06 20:31:21,2023-03-06,9113,6,9107,B56
16811,9081,1,2023-03-10 17:01:09,2023-03-10,4345,39,4306,A50
68556,1397,0,2023-03-21 11:18:40,2023-03-21,4074,97,3977,A36
23206,3581,0,2023-03-25 05:45:41,2023-03-25,1892,40,1852,A40
87136,6774,0,2023-03-14 20:41:48,2023-03-14,9809,28,9781,A79
87602,4233,0,2023-03-19 11:08:43,2023-03-19,7380,46,7334,A65
83103,4221,0,2023-03-16 07:33:40,2023-03-16,1301,51,1250,A93
64477,7199,0,2023-02-28 01:54:44,2023-02-28,834,16,818,A87
90675,4116,0,2023-03-19 01:13:27,2023-03-19,9910,19,9891,B31
82618,3256,0,2023-03-09 05:36:19,2023-03-09,7799,64,7735,A70
29642,5929,0,2023-03-03 19:00:09,2023-03-03,3631,75,3556,A73
1771,3537,0,2023-03-29 00:36:42,2023-03-29,6645,31,6614,A31
5866,9233,1,2023-03-09 03:44:21,2023-03-09,1934,29,1905,A67
44965,8730,0,2023-03-03 09:06:29,2023-03-03,6021,8,6013,B73
3322,4990,0,2023-03-10 23:49:20,2023-03-10,4264,83,4181,A62
3175,8427,0,2023-03-15 04:17:16,2023-03-15,1144,54,1090,A22
19408,9077,0,2023-03-17 21:33:55,2023-03-17,4796,84,4712,A29
57605,8737,1,2023-03-24 18:18:02,2023-03-24,489,98,391,A54
77153,1564,0,2023-03-21 05:46:10,2023-03-21,7840,20,7820,A86
66420,7493,0,2023-03-26 05:22:21,2023-03-26,6140,70,6070,A60
81254,2509,0,2023-03-18 15:52:23,2023-03-18,6581,88,6493,B09
25095,9145,1,2023-03-16 11:00:47,2023-03-16,7924,49,7875,B45
29619,1059,0,2023-03-16 14:41:06,2023-03-16,1574,80,1494,A52
41822,5139,0,2023-03-18 21:58:59,2023-03-18,6460,45,6415,A93
72031,9058,0,2023-03-09 02:36:18,2023-03-09,5332,45,5287,B31
54444,7807,0,2023-03-07 17:14:22,2023-03-07,3566,97,3469,B45
68899,8532,0,2023-03-28 21:54:04,2023-03-28,2894,92,2802,B17
92156,4096,0,2023-03-14 23:44:50,2023-03-14,811,47,764,B08
16052,1353,0,2023-03-13 22:01:10,2023-03-13,2669,31,2638,A93
54391,7879,0,2023-03-13 16:46:07,2023-03-13,7448,19,7429,B73
21396,9218,0,2023-03-17 22:26:51,2023-03-17,2394,56,2338,B16
52598,4783,0,2023-03-08 23:38:15,2023-03-08,1434,89,1345,B01
6125,1452,0,2023-03-25 07:38:12,2023-03-25,5625,93,5532,A54
48695,1664,0,2023-03-23 03:28:08,2023-03-23,390,53,337,A41
69510,1586,0,2023-03-29 06:59:47,2023-03-29,9088,17,9071,B15
78953,4150,0,2023-03-25 07:24:10,2023-03-25,5901,65,5836,B55
4020,8880,0,2023-03-08 17:48:27,2023-03-08,8369,71,8298,B87
37395,4682,0,2023-02-28 04:11:47,2023-02-28,3652,76,3576,B45
6617,8667,0,2023-03-28 03:33:55,2023-03-28,6062,16,6046,A76
84525,2185,0,2023-03-06 07:32:19,2023-03-06,6857,50,6807,A81
51824,8261,0,2023-03-04 02:00:30,2023-03-04,8134,46,8088,B14
42668,7579,0,2023-03-04 21:49:44,2023-03-04,9191,28,9163,A25
62878,2395,0,2023-03-29 00:54:50,2023-03-29,5586,22,5564,A25
64769,1808,0,2023-03-25 01:35:51,2023-03-25,2362,32,2330,B64
26491,6929,0,2023-03-28 06:12:36,2023-03-28,7340,80,7260,B72
39342,1383,0,2023-03-11 16:02:36,2023-03-11,4467,78,4389,B18
83369,2346,0,2023-03-11 16:48:24,2023-03-11,1573,71,1502,A66
385,3706,0,2023-03-24 05:34:52,2023-03-24,2415,83,2332,A21
96918,7144,0,2023-03-03 04:17:40,2023-03-03,1212,9,1203,A08
31575,1840,0,2023-03-02 00:14:36,2023-03-02,6233,77,6156,B66
99388,4967,0,2023-03-17 07:17:07,2023-03-17,6357,73,6284,A73
43576,9848,0,2023-03-03 21:20:23,2023-03-03,7781,9,7772,A30
22205,8933,0,2023-03-17 16:52:43,2023-03-17,8721,62,8659,A42
47273,4720,0,2023-03-12 23:07:19,2023-03-12,1175,59,1116,A29
17550,4000,0,2023-03-28 22:58:06,2023-03-28,712,75,637,A75
89420,1163,0,2023-03-05 12:30:57,2023-03-05,1051,41,1010,A88
70713,5968,0,2023-03-12 01:34:22,2023-03-12,8410,57,8353,B18
53351,9616,0,2023-03-16 07:30:13,2023-03-16,2380,3,2377,A40
43631,7383,0,2023-03-10 00:38:55,2023-03-10,762,43,719,A33
4099,5466,0,2023-03-15 12:12:24,2023-03-15,2403,8,2395,B57
85067,4784,0,2023-03-14 16:47:09,2023-03-14,7339,71,7268,A19
23898,5633,1,2023-03-04 13:08:17,2023-03-04,2129,29,2100,A31
88472,1300,0,2023-03-17 22:22:46,2023-03-17,5502,28,5474,A79
10627,9321,0,2023-03-15 11:25:18,2023-03-15,3138,84,3054,A03
85565,1419,0,2023-03-24 14:20:52,2023-03-24,3014,29,2985,A76
74265,4788,0,2023-03-06 07:04:32,2023-03-06,4704,94,4610,B86
63308,9920,0,2023-03-17 12:35:01,2023-03-17,5682,36,5646,A47
78749,9154,0,2023-03-29 09:36:49,2023-03-29,5213,61,5152,B70
64392,5485,1,2023-03-16 04:50:49,2023-03-16,4603,48,4555,B53
53191,5318,0,2023-03-20 13:30:59,2023-03-20,3416,29,3387,A44
75583,3498,0,2023-03-23 23:59:54,2023-03-23,6590,19,6571,A82
97460,1058,0,2023-03-25 07:06:52,2023-03-25,5415,2,5413,B54
5777,6090,0,2023-03-15 22:49:56,2023-03-15,4751,65,4686,B42
58974,5927,0,2023-03-22 13:12:31,2023-03-22,462,6,456,A98
87417,8165,0,2023-03-23 12:47:14,2023-03-23,3037,88,2949,A50
65322,8635,0,2023-02-28 23:21:14,2023-02-28,4494,27,4467,A26
19022,9901,0,2023-03-12 02:44:15,2023-03-12,1271,71,1200,A80
39843,9054,0,2023-03-16 03:27:39,2023-03-16,8441,69,8372,A06
50861,6764,0,2023-02-28 09:40:36,2023-02-28,3426,52,3374,B72
12463,3279,0,2023-03-08 01:10:27,2023-03-08,3585,15,3570,A44
49499,2766,0,2023-03-22 20:03:33,2023-03-22,2789,1,2788,B44
7985,3013,0,2023-03-09 11:03:19,2023-03-09,8414,7,8407,B11
49797,6388,0,2023-03-06 10:26:05,2023-03-06,4869,88,4781,A07
40994,7213,0,2023-03-18 17:29:57,2023-03-18,2055,65,1990,B12
37010,7050,0,2023-03-21 06:58:47,2023-03-21,6958,97,6861,B61
20252,9496,0,2023-03-25 06:05:53,2023-03-25,6114,66,6048,A89
15132,5626,0,2023-03-23 04:23:03,2023-03-23,7824,100,7724,A85
48681,5765,1,2023-03-29 11:00:48,2023-03-29,7786,99,7687,B02
88020,5721,0,2023-03-22 16:15:02,2023-03-22,1539,65,1474,A83
89608,3700,0,2023-03-05 08:34:02,2023-03-05,1650,10,1640,B55
93652,2033,0,2023-03-19 04:23:30,2023-03-19,6170,51,6119,B14
79304,5695,0,2023-02-28 06:47:08,2023-02-28,1788,74,1714,B03
58768,4836,0,2023-03-19 06:09:34,2023-03-19,4011,2,4009,A73
44369,9167,0,2023-03-21 06:57:51,2023-03-21,6095,16,6079,A18
24161,4793,0,2023-03-06 04:29:51,2023-03-06,1739,92,1647,A67
61942,7556,0,2023-03-16 18:25:05,2023-03-16,8140,69,8071,A06
16389,3162,0,2023-03-17 03:55:26,2023-03-17,3748,0,3748,A95
48357,3571,0,2023-03-12 02:18:14,2023-03-12,9774,76,9698,B45
3563,5586,0,2023-03-21 07:01:57,2023-03-21,4528,52,4476,B79
69317,4107,0,2023-02-28 15:35:36,2023-02-28,553,3,550,B32
93197,6169,0,2023-03-04 20:15:31,2023-03-04,4182,86,4096,B11
85789,2752,0,2023-03-07 08:44:16,2023-03-07,2902,8,2894,B27
79951,7924,0,2023-03-24 03:50:46,2023-03-24,987,24,963,B54
7574,5128,0,2023-03-01 00:05:00,2023-03-01,6010,6,6004,B08
5393,1169,0,2023-03-20 06:55:03,2023-03-20,8236,10,8226,A07
5707,5261,0,2023-03-23 14:46:43,2023-03-23,1198,86,1112,A58
48133,4417,0,2023-03-27 09:31:56,2023-03-27,2397,10,2387,A62
83126,8988,0,2023-03-07 11:21:44,2023-03-07,9588,20,9568,A83
6780,1145,0,2023-03-19 02:06:39,2023-03-19,3995,71,3924,A51
73439,8415,0,2023-03-15 22:02:11,2023-03-15,9063,52,9011,B53
95733,2866,0,2023-03-28 17:48:42,2023-03-28,8085,42,8043,B86
95043,3802,0,2023-03-21 15:48:44,2023-03-21,8392,84,8308,B70
84736,7509,0,2023-03-13 16:48:29,2023-03-13,1675,49,1626,A06
26957,2650,0,2023-03-05 14:09:01,2023-03-05,2320,82,2238,A86
2593,6644,0,2023-03-15 05:04:19,2023-03-15,5595,87,5508,B90
1639,1501,0,2023-03-12 06:58:04,2023-03-12,2239,74,2165,A86
71370,9683,0,2023-03-26 00:16:24,2023-03-26,2114,57,2057,B49
19502,5805,0,2023-03-07 18:42:44,2023-03-07,2452,20,2432,A27
7069,2542,0,2023-03-10 22:18:34,2023-03-10,7101,9,7092,A06
44962,9693,0,2023-03-23 20:31:22,2023-03-23,1975,19,1956,B70
96088,6792,0,2023-03-16 05:07:24,2023-03-16,880,99,781,A88
9043,9757,0,2023-03-08 17:46:54,2023-03-08,2509,35,2474,A99
21937,8931,0,2023-03-22 02:44:11,2023-03-22,2587,4,2583,B27
89207,9129,0,2023-03-10 16:22:46,2023-03-10,3032,33,2999,A36
68075,6855,0,2023-03-01 04:55:28,2023-03-01,2192,61,2131,A60
36159,8788,0,2023-03-28 05:17:48,2023-03-28,310,97,213,A48
9885,9375,0,2023-03-27 10:22:44,2023-03-27,6643,43,6600,B08
48053,7044,0,2023-03-16 02:54:23,2023-03-16,5425,3,5422,A56
88107,5169,0,2023-03-06 12:36:43,2023-03-06,2222,56,2166,B11
45256,4114,1,2023-03-12 14:27:55,2023-03-12,3575,94,3481,A33
48447,6331,0,2023-03-07 18:22:12,2023-03-07,7456,72,7384,A73
35571,9240,0,2023-03-09 00:56:37,2023-03-09,8768,15,8753,B59
64510,6524,0,2023-03-12 12:39:00,2023-03-12,3767,90,3677,A31
58291,6948,0,2023-03-29 04:57:48,2023-03-29,3308,98,3210,A28
59256,2901,0,2023-03-07 01:23:10,2023-03-07,7998,86,7912,B90
54131,7334,0,2023-03-05 12:53:44,2023-03-05,1636,50,1586,B07
79571,3219,0,2023-03-20 05:19:48,2023-03-20,7769,1,7768,B76
27850,9783,0,2023-03-19 14:04:39,2023-03-19,8923,10,8913,A12
68650,9508,0,2023-03-05 17:05:56,2023-03-05,2589,57,2532,B27
81400,1213,0,2023-03-08 00:33:55,2023-03-08,4276,13,4263,A13
27649,8398,0,2023-03-13 03:31:29,2023-03-13,398,4,394,B74
48330,7263,1,2023-03-29 02:28:33,2023-03-29,1578,95,1483,A80
43995,1056,0,2023-03-12 22:10:08,2023-03-12,6260,0,6260,A73
51413,6955,0,2023-03-14 23:56:25,2023-03-14,2479,26,2453,A41
63273,7850,0,2023-03-26 16:07:03,2023-03-26,6080,40,6040,A22
57108,5151,0,2023-03-05 08:39:01,2023-03-05,7861,57,7804,A15
42464,9261,0,2023-03-10 22:13:53,2023-03-10,290,93,197,A95
6368,7809,0,2023-03-03 04:48:45,2023-03-03,5732,72,5660,A73
63061,2394,0,2023-03-23 15:49:27,2023-03-23,7269,34,7235,A89
17960,2485,0,2023-03-07 13:41:31,2023-03-07,4022,84,3938,A14
16112,7142,0,2023-03-29 16:23:16,2023-03-29,9981,48,9933,B57
20783,4429,0,2023-03-11 10:52:14,2023-03-11,2043,89,1954,A90
10632,8635,0,2023-03-13 04:09:48,2023-03-13,8380,32,8348,A19
5494,1150,0,2023-02-28 22:43:20,2023-02-28,3573,13,3560,B07
50317,1402,0,2023-03-06 03:26:09,2023-03-06,8761,90,8671,A27
96623,7074,0,2023-03-05 14:23:42,2023-03-05,1488,56,1432,A48
77056,9844,0,2023-03-26 09:08:10,2023-03-26,1624,95,1529,B65
46761,4677,0,2023-03-11 05:37:02,2023-03-11,5026,99,4927,A54
63583,4447,0,2023-03-11 10:50:48,2023-03-11,3220,98,3122,B02
81536,6744,0,2023-03-16 18:30:06,2023-03-16,3557,83,3474,B15
27588,6626,0,2023-03-12 23:15:07,2023-03-12,5162,48,5114,B18
81687,3032,0,2023-03-17 18:52:52,2023-03-17,5761,40,5721,A03
89164,1907,0,2023-03-03 15:22:49,2023-03-03,8746,96,8650,B75
54555,2978,0,2023-03-03 06:00:27,2023-03-03,7776,78,7698,B27
71195,5525,0,2023-03-05 22:05:10,2023-03-05,7224,62,7162,B65
20517,9426,0,2023-03-26 13:37:52,2023-03-26,2516,64,2452,A16
30424,6142,0,2023-03-12 01:40:04,2023-03-12,9136,76,9060,B04
52572,5239,0,2023-03-17 18:44:07,2023-03-17,4441,3,4438,B08
11921,3871,0,2023-03-15 21:03:15,2023-03-15,6855,60,6795,B48
85655,9717,0,2023-03-13 06:07:35,2023-03-13,1978,69,1909,B44
76397,1272,0,2023-03-20 18:27:19,2023-03-20,1999,91,1908,B66
24378,7813,0,2023-03-15 07:11:27,2023-03-15,2028,81,1947,A40
87827,4340,0,2023-03-21 18:49:57,2023-03-21,3877,47,3830,A11
41312,1056,0,2023-03-20 23:22:46,2023-03-20,9923,1,9922,A13
39037,4237,0,2023-03-24 11:05:22,2023-03-24,4555,2,4553,B81
77285,2418,0,2023-03-16 07:48:09,2023-03-16,2671,36,2635,A81
49364,1159,1,2023-03-16 03:18:48,2023-03-16,9292,46,9246,B55
6168,9318,0,2023-03-11 04:17:03,2023-03-11,7754,86,7668,A47
57024,2623,0,2023-03-19 20:13:45,2023-03-19,6465,31,6434,A12
22840,1470,0,2023-03-13 16:06:27,2023-03-13,9943,34,9909,A14
69193,2659,0,2023-03-04 03:12:02,2023-03-04,6040,79,5961,A94
9211,9816,0,2023-03-18 03:40:37,2023-03-18,6932,29,6903,A84
2247,7380,0,2023-03-21 10:18:10,2023-03-21,3457,63,3394,B50
42626,3646,0,2023-03-01 16:55:36,2023-03-01,8498,21,8477,A31
37546,7254,0,2023-03-03 03:09:42,2023-03-03,1271,70,1201,B58
23117,8818,0,2023-03-11 11:42:53,2023-03-11,9984,98,9886,A40
52726,5901,0,2023-03-22 09:36:09,2023-03-22,1291,7,1284,A13
78986,3289,0,2023-03-17 11:35:33,2023-03-17,3784,88,3696,B21
8123,3310,0,2023-03-24 19:50:06,2023-03-24,4905,11,4894,A16
59283,3943,0,2023-03-28 00:55:33,2023-03-28,866,12,854,B05
46160,7797,0,2023-03-10 09:28:20,2023-03-10,6606,4,6602,A81
19323,1007,0,2023-03-03 20:22:31,2023-03-03,7203,87,7116,A34
22931,2909,0,2023-03-26 11:46:53,2023-03-26,8616,39,8577,B65
35868,5954,0,2023-03-17 04:26:56,2023-03-17,9490,27,9463,B26
59293,3631,0,2023-03-07 23:28:06,2023-03-07,8212,38,8174,B71
99251,2405,0,2023-03-02 22:16:11,2023-03-02,7316,82,7234,A63
4464,9724,0,2023-03-11 09:02:21,2023-03-11,171,10,161,A85
42986,8735,0,2023-03-10 01:09:30,2023-03-10,8036,28,8008,A12
14589,6977,0,2023-03-28 10:30:22,2023-03-28,6343,31,6312,B21
9956,6733,1,2023-03-12 14:23:49,2023-03-12,7524,11,7513,A93
56745,5061,0,2023-03-22 17:33:38,2023-03-22,9741,35,9706,A04
73686,7126,0,2023-03-06 00:05:31,2023-03-06,7356,76,7280,A44
22034,8862,0,2023-03-08 03:56:52,2023-03-08,5159,11,5148,A14
9864,4359,0,2023-03-12 12:10:45,2023-03-12,6949,35,6914,B24
7951,9594,0,2023-03-08 14:47:51,2023-03-08,8134,5,8129,A46
18854,6518,0,2023-03-23 02:58:08,2023-03-23,9357,61,9296,B24
61617,5762,0,2023-03-23 21:45:28,2023-03-23,8221,40,8181,B22
38071,9395,0,2023-03-12 07:37:06,2023-03-12,6516,36,6480,B48
53822,9953,0,2023-03-20 20:07:57,2023-03-20,3897,40,3857,A42
79510,9111,0,2023-03-11 10:14:53,2023-03-11,8510,63,8447,A50
2474,3446,0,2023-03-10 20:30:09,2023-03-10,8876,62,8814,A55
76549,7973,0,2023-03-07 06:08:28,2023-03-07,3408,40,3368,A16
41959,8686,0,2023-03-27 02:41:50,2023-03-27,156,73,83,A44
7137,9834,0,2023-03-29 00:22:20,2023-03-29,1118,48,1070,A83
41077,8971,0,2023-03-05 15:08:52,2023-03-05,3172,26,3146,B71
90957,1058,0,2023-03-08 12:48:14,2023-03-08,5577,20,5557,B90
24586,8128,0,2023-03-11 23:07:47,2023-03-11,5737,57,5680,A73
94318,7498,0,2023-03-20 15:17:03,2023-03-20,4624,93,4531,A14
82946,3536,0,2023-03-15 12:17:06,2023-03-15,9910,29,9881,A55
21885,5579,0,2023-03-14 20:13:28,2023-03-14,346,1,345,A09
53278,7849,0,2023-03-13 15:16:42,2023-03-13,9522,88,9434,B90
84,8949,1,2023-03-08 06:48:08,2023-03-08,6102,73,6029,A36
68367,7431,0,2023-03-21 02:07:48,2023-03-21,2290,8,2282,A28
77054,5446,0,2023-03-19 20:03:56,2023-03-19,9219,15,9204,B31
86041,3602,0,2023-03-08 21:45:38,2023-03-08,5083,2,5081,B61
9631,7765,0,2023-03-10 23:38:20,2023-03-10,3588,50,3538,A12
62108,1660,0,2023-03-22 03:12:48,2023-03-22,6993,75,6918,A06
97374,2286,0,2023-03-03 03:25:02,2023-03-03,1274,83,1191,B05
78751,6352,0,2023-03-08 08:34:32,2023-03-08,1195,72,1123,A67
59394,6646,0,2023-03-09 22:37:13,2023-03-09,8635,98,8537,A42
73177,1838,0,2023-03-25 15:52:34,2023-03-25,5044,36,5008,B22
94851,1588,0,2023-03-16 15:00:25,2023-03-16,9767,56,9711,A55
7909,4921,0,2023-03-02 07:30:16,2023-03-02,2071,68,2003,B80
79369,3030,0,2023-03-17 01:49:53,2023-03-17,2300,19,2281,A70
42380,4885,0,2023-03-10 09:59:48,2023-03-10,8301,24,8277,A73
94444,7458,0,2023-03-18 18:53:20,2023-03-18,2834,6,2828,A73
78180,8454,0,2023-03-06 23:30:08,2023-03-06,1039,67,972,A56
37863,5991,0,2023-03-21 17:47:36,2023-03-21,3172,51,3121,A88
44390,3266,0,2023-03-23 01:07:03,2023-03-23,1679,99,1580,B78
71563,3608,0,2023-03-15 09:21:41,2023-03-15,9826,1,9825,B86
97524,9763,0,2023-03-26 17:44:38,2023-03-26,7533,45,7488,B82
82103,4739,0,2023-03-01 21:21:01,2023-03-01,4725,63,4662,A12
90152,1379,0,2023-03-25 02:39:53,2023-03-25,8311,17,8294,B55
84356,6781,0,2023-03-14 13:23:27,2023-03-14,4329,33,4296,B42
79112,9446,0,2023-03-26 10:31:05,2023-03-26,2772,12,2760,A42
12608,2139,0,2023-03-01 17:25:46,2023-03-01,3911,0,3911,B88
45401,7844,1,2023-02-27 21:44:47,2023-02-27,2836,21,2815,A89
11561,5875,0,2023-03-28 16:03:01,2023-03-28,4970,67,4903,B46
42323,6454,0,2023-03-25 18:53:51,2023-03-25,4907,67,4840,A57
55890,8415,1,2023-03-24 15:56:53,2023-03-24,2620,24,2596,A54
74171,6549,0,2023-03-16 06:21:44,2023-03-16,331,13,318,A72
73092,2381,0,2023-03-18 16:52:52,2023-03-18,1171,54,1117,A59
45496,7735,0,2023-02-28 07:35:36,2023-02-28,647,37,610,B78
13488,5624,0,2023-03-02 09:08:49,2023-03-02,4541,78,4463,A05
86124,3540,0,2023-03-04 04:21:20,2023-03-04,3059,87,2972,B09
9932,2111,0,2023-03-03 00:53:16,2023-03-03,4991,32,4959,A80
975,7422,0,2023-03-05 01:37:15,2023-03-05,873,71,802,B44
44673,3544,0,2023-03-29 03:15:38,2023-03-29,1963,52,1911,B69
25859,6221,0,2023-03-05 04:06:59,2023-03-05,6501,26,6475,A81
47267,7989,0,2023-03-10 22:32:17,2023-03-10,1351,65,1286,A58
17258,1862,0,2023-03-21 10:06:59,2023-03-21,8374,37,8337,B26
54518,8595,0,2023-03-05 04:18:42,2023-03-05,4480,83,4397,B08
79026,9574,0,2023-03-16 01:17:28,2023-03-16,8773,66,8707,A03
73582,6390,0,2023-03-08 05:35:23,2023-03-08,7159,67,7092,A88
81521,3712,0,2023-03-14 00:43:46,2023-03-14,1562,24,1538,A40
89882,9408,0,2023-02-28 13:14:38,2023-02-28,2482,60,2422,A40
7035,6321,0,2023-03-17 22:08:44,2023-03-17,5914,73,5841,A84
98534,5024,0,2023-03-19 08:49:54,2023-03-19,5369,83,5286,B08
60245,4790,0,2023-03-04 03:49:01,2023-03-04,1388,49,1339,A70
14593,6066,0,2023-03-13 11:28:09,2023-03-13,6036,9,6027,A55
63746,9437,0,2023-03-19 19:15:01,2023-03-19,1107,9,1098,A48
28237,9736,0,2023-03-21 07:46:48,2023-03-21,4761,83,4678,B32
21632,6404,0,2023-03-04 18:16:24,2023-03-04,9122,31,9091,B76
96733,8462,0,2023-02-28 05:47:26,2023-02-28,7563,88,7475,B07
88096,7914,0,2023-03-20 16:57:32,2023-03-20,1689,46,1643,B07
95137,4554,0,2023-02-28 03:46:47,2023-02-28,3458,58,3400,B27
28104,8219,0,2023-02-28 17:10:11,2023-02-28,5420,71,5349,B88
54447,6786,0,2023-02-28 02:02:36,2023-02-28,5873,10,5863,A55
11253,6305,0,2023-03-26 19:35:11,2023-03-26,7425,15,7410,B80
54279,2990,0,2023-03-16 13:51:25,2023-03-16,5939,48,5891,A36
38941,3371,0,2023-03-27 12:29:16,2023-03-27,2115,50,2065,A14
68276,7149,0,2023-03-14 21:54:39,2023-03-14,3503,31,3472,B86
3570,1576,0,2023-03-03 15:23:50,2023-03-03,5631,61,5570,A02
5653,2996,0,2023-03-11 08:18:03,2023-03-11,7170,14,7156,A30
74485,9824,0,2023-03-22 19:17:07,2023-03-22,7178,9,7169,B50
73962,2880,0,2023-03-01 04:59:07,2023-03-01,3833,77,3756,B16
11190,8752,0,2023-03-11 11:04:43,2023-03-11,5376,6,5370,A43
15208,4427,0,2023-03-25 03:23:04,2023-03-25,8541,28,8513,B59
87707,4144,0,2023-03-14 05:17:01,2023-03-14,1152,26,1126,A16
67205,9934,0,2023-03-05 14:07:32,2023-03-05,3125,66,3059,B64
68744,2841,0,2023-03-02 07:43:23,2023-03-02,5087,3,5084,B49
87686,7682,0,2023-03-22 05:37:17,2023-03-22,5927,88,5839,B09
58748,7254,0,2023-03-02 22:44:24,2023-03-02,576,79,497,A25
80237,1922,0,2023-03-24 16:23:14,2023-03-24,6490,92,6398,A26
47276,3477,0,2023-03-04 23:55:52,2023-03-04,6963,55,6908,B05
65772,6492,0,2023-03-28 08:03:54,2023-03-28,439,47,392,A58
14115,6883,0,2023-03-24 09:12:27,2023-03-24,6931,14,6917,A17
76223,2886,0,2023-03-22 07:25:32,2023-03-22,9496,72,9424,B76
91663,9570,0,2023-03-25 01:46:38,2023-03-25,9478,0,9478,A84
99233,4212,0,2023-03-13 09:03:03,2023-03-13,9207,70,9137,B16
59501,6955,0,2023-03-23 09:32:23,2023-03-23,701,18,683,A84
83481,5768,0,2023-03-22 12:52:21,2023-03-22,5894,99,5795,A65
16954,5120,0,2023-03-15 01:52:43,2023-03-15,9615,44,9571,A51
30554,6047,0,2023-03-19 08:34:08,2023-03-19,8030,55,7975,B10
70997,5137,0,2023-03-20 13:55:13,2023-03-20,6814,28,6786,A41
37665,7431,0,2023-03-26 05:27:24,2023-03-26,599,90,509,A90
59592,6642,0,2023-03-11 20:36:35,2023-03-11,6147,3,6144,A86
72524,7446,0,2023-03-13 10:02:02,2023-03-13,7423,39,7384,A70
57253,1153,0,2023-02-27 20:08:02,2023-02-27,7848,28,7820,A75
6312,9716,0,2023-03-10 19:43:39,2023-03-10,4526,1,4525,B85
71105,4829,0,2023-03-06 03:10:04,2023-03-06,7384,20,7364,A12
47735,4857,0,2023-03-24 07:04:32,2023-03-24,4896,51,4845,B80
31183,6655,0,2023-03-22 07:50:08,2023-03-22,5968,91,5877,B78
46539,7523,0,2023-03-01 08:41:40,2023-03-01,4592,91,4501,B16
97628,2230,0,2023-03-06 05:02:57,2023-03-06,4758,9,4749,B01
97992,2705,0,2023-03-28 21:15:28,2023-03-28,3995,51,3944,B17
97310,7530,0,2023-03-18 02:06:51,2023-03-18,2445,66,2379,A22
38909,9319,0,2023-03-24 20:15:10,2023-03-24,4978,17,4961,B80
28697,4370,1,2023-03-01 07:52:03,2023-03-01,4096,94,4002,A39
92466,2498,0,2023-03-28 04:39:23,2023-03-28,3423,74,3349,A83
21941,5596,0,2023-03-07 22:20:12,2023-03-07,1346,79,1267,B54
46312,5739,0,2023-03-06 14:59:44,2023-03-06,4422,52,4370,A54
34285,6021,0,2023-03-21 03:00:18,2023-03-21,1790,33,1757,A96
60609,2458,0,2023-03-18 20:54:22,2023-03-18,9433,29,9404,A03
89052,5960,0,2023-03-22 04:03:57,2023-03-22,819,28,791,A98
3134,9356,0,2023-03-16 01:30:34,2023-03-16,9306,39,9267,B85
22601,2207,0,2023-03-19 07:26:00,2023-03-19,847,15,832,A54
1023,9925,0,2023-03-08 04:26:12,2023-03-08,8425,30,8395,A90
17943,4179,0,2023-03-08 02:30:24,2023-03-08,3693,43,3650,B16
95859,3269,0,2023-03-15 01:10:52,2023-03-15,605,89,516,A60
94449,4863,0,2023-03-03 15:46:27,2023-03-03,2271,4,2267,B86
58410,9069,0,2023-03-01 22:35:29,2023-03-01,1152,26,1126,A18
2134,6421,0,2023-03-13 15:32:11,2023-03-13,4183,69,4114,A62
64832,5005,0,2023-03-10 16:52:52,2023-03-10,9790,74,9716,B59
45155,4623,0,2023-03-12 08:35:42,2023-03-12,5580,100,5480,A84
48922,3940,0,2023-03-11 06:54:49,2023-03-11,4883,95,4788,B50
46443,5848,0,2023-03-27 08:36:24,2023-03-27,5532,60,5472,A51
55993,9744,0,2023-03-12 07:40:51,2023-03-12,8154,73,8081,A19
29867,5485,0,2023-03-14 12:57:50,2023-03-14,3305,54,3251,A33
97545,6548,0,2023-03-07 11:33:01,2023-03-07,5252,52,5200,A36
80329,8754,0,2023-03-23 15:01:06,2023-03-23,3307,70,3237,B05
97724,2446,0,2023-03-04 06:27:21,2023-03-04,6350,30,6320,A61
91604,9466,0,2023-03-28 01:17:51,2023-03-28,6794,65,6729,B68
16128,1195,1,2023-03-09 08:08:54,2023-03-09,846,78,768,A48
46180,4842,0,2023-03-28 23:41:50,2023-03-28,7328,68,7260,B05
47675,7960,1,2023-03-13 13:48:49,2023-03-13,4146,54,4092,A27
79575,9384,0,2023-03-17 23:12:36,2023-03-17,8541,64,8477,A67
3341,9487,0,2023-03-10 05:38:02,2023-03-10,4805,69,4736,A70
84135,6182,0,2023-03-23 16:53:41,2023-03-23,9393,86,9307,A44
64544,3543,0,2023-03-05 23:24:21,2023-03-05,9003,99,8904,A50
38045,5542,0,2023-03-17 22:07:58,2023-03-17,1532,1,1531,B11
25884,4682,0,2023-03-19 12:25:38,2023-03-19,3073,41,3032,B70
28000,3076,0,2023-03-01 15:39:08,2023-03-01,3630,34,3596,A88
59748,8658,0,2023-03-21 19:49:17,2023-03-21,5170,61,5109,A75
65113,9912,0,2023-03-25 18:23:36,2023-03-25,2541,76,2465,B66
46352,7727,0,2023-02-28 01:37:54,2023-02-28,1163,41,1122,B71
10289,1610,0,2023-03-21 10:19:09,2023-03-21,4756,95,4661,A02
16988,8667,0,2023-03-28 19:46:53,2023-03-28,6434,70,6364,B02
78329,3501,0,2023-03-01 08:08:09,2023-03-01,9193,22,9171,A89
18131,9829,0,2023-03-02 11:46:31,2023-03-02,6915,4,6911,A61
54624,9873,0,2023-02-28 14:17:35,2023-02-28,6669,44,6625,B61
85861,1065,0,2023-03-09 00:59:01,2023-03-09,8029,87,7942,A18
82996,9472,0,2023-03-16 18:40:39,2023-03-16,587,47,540,B70
91511,6992,0,2023-03-18 16:20:59,2023-03-18,2818,62,2756,A42
4847,7015,0,2023-03-24 09:31:40,2023-03-24,9474,94,9380,B57
52537,5550,0,2023-03-11 19:03:03,2023-03-11,1498,2,1496,A10
84601,6665,0,2023-03-23 18:28:24,2023-03-23,6398,10,6388,B45
19038,9945,0,2023-03-04 07:51:17,2023-03-04,6017,64,5953,B50
93415,6178,0,2023-03-17 12:55:08,2023-03-17,6354,0,6354,B51
4516,2237,0,2023-03-17 22:52:28,2023-03-17,3609,35,3574,B72
81525,4013,0,2023-03-05 19:38:18,2023-03-05,6690,94,6596,B82
72553,3466,0,2023-03-07 01:55:57,2023-03-07,2540,54,2486,B08
41525,8507,0,2023-03-15 04:13:04,2023-03-15,6222,88,6134,A47
66521,4569,0,2023-03-11 07:24:13,2023-03-11,4190,58,4132,B53
76777,5651,0,2023-03-18 19:46:49,2023-03-18,3146,58,3088,B79
3550,5304,0,2023-03-26 16:01:58,2023-03-26,5778,78,5700,B21
18648,9460,0,2023-03-02 04:57:35,2023-03-02,9597,79,9518,B54
49469,8838,0,2023-03-17 22:59:48,2023-03-17,6695,5,6690,B48
35281,9538,0,2023-03-23 15:13:25,2023-03-23,9042,38,9004,A40
72552,8377,0,2023-03-15 00:51:17,2023-03-15,7189,90,7099,A25
94476,5059,0,2023-03-18 23:50:35,2023-03-18,6661,100,6561,A98
11788,1479,0,2023-03-21 17:21:46,2023-03-21,1496,18,1478,A63
2054,2208,0,2023-03-19 07:16:41,2023-03-19,2838,32,2806,A80
54125,6190,0,2023-03-23 18:19:16,2023-03-23,7320,96,7224,A94
25084,6927,0,2023-03-28 23:20:44,2023-03-28,1365,97,1268,A15
94124,6409,0,2023-03-13 04:42:54,2023-03-13,7691,4,7687,A75
60780,2832,0,2023-03-27 20:38:57,2023-03-27,3957,30,3927,B56
42839,3985,0,2023-03-17 03:25:13,2023-03-17,4191,1,4190,A31
84328,2000,0,2023-03-23 12:46:21,2023-03-23,5864,18,5846,A52
61778,2970,0,2023-03-23 16:46:08,2023-03-23,9672,63,9609,A03
93844,6097,0,2023-03-07 09:53:06,2023-03-07,689,55,634,A09
27363,6528,0,2023-03-14 09:36:48,2023-03-14,7992,13,7979,A87
70081,1842,0,2023-03-05 21:59:30,2023-03-05,6816,1,6815,A17
23953,1282,0,2023-03-04 21:46:22,2023-03-04,4214,71,4143,A47
45321,1669,0,2023-03-08 07:51:56,2023-03-08,4960,91,4869,A55
86540,2503,0,2023-03-15 00:19:37,2023-03-15,2823,84,2739,A46
13075,5451,0,2023-03-24 16:48:04,2023-03-24,8870,30,8840,A60
20012,7239,0,2023-03-13 07:30:47,2023-03-13,1501,41,1460,A80
12079,2559,0,2023-03-21 10:37:47,2023-03-21,4420,40,4380,A73
77042,5413,0,2023-03-14 03:35:16,2023-03-14,3803,18,3785,A12
2225,3072,0,2023-03-09 03:51:03,2023-03-09,5566,46,5520,A48
55464,8725,0,2023-03-25 14:37:47,2023-03-25,1880,20,1860,A22
80175,1257,0,2023-03-25 10:51:03,2023-03-25,7570,1,7569,B68
87833,9340,0,2023-03-13 09:32:52,2023-03-13,9195,94,9101,A61
95015,3770,1,2023-03-24 14:22:17,2023-03-24,4529,21,4508,A79
53532,9453,0,2023-03-11 17:31:41,2023-03-11,6696,6,6690,A94
57150,6356,0,2023-03-21 04:15:41,2023-03-21,9259,13,9246,B60
73886,1681,0,2023-03-15 14:55:50,2023-03-15,9980,76,9904,B31
79925,6055,0,2023-03-19 05:34:25,2023-03-19,4669,77,4592,A86
79700,6688,0,2023-03-15 00:41:45,2023-03-15,3083,62,3021,A81
73753,3144,0,2023-03-18 02:18:56,2023-03-18,8043,18,8025,B54
17805,4812,0,2023-03-02 18:54:42,2023-03-02,6204,7,6197,A06
10455,2350,0,2023-02-28 22:18:44,2023-02-28,5352,23,5329,A43
95855,5540,0,2023-03-04 11:44:48,2023-03-04,3623,23,3600,A83
60984,3041,0,2023-03-28 02:23:44,2023-03-28,4432,8,4424,A86
55219,7370,0,2023-03-18 13:12:11,2023-03-18,381,93,288,A93
75000,9667,0,2023-03-04 18:49:43,2023-03-04,2063,12,2051,A92
14499,3851,0,2023-03-16 05:00:25,2023-03-16,3516,4,3512,B61
42975,2942,0,2023-03-09 07:16:33,2023-03-09,9330,22,9308,A34
87933,4772,0,2023-03-28 15:26:29,2023-03-28,512,89,423,B24
92692,4324,0,2023-03-09 05:24:44,2023-03-09,6230,24,6206,B66
59594,3121,0,2023-03-20 21:36:10,2023-03-20,2292,42,2250,B76
26197,4534,0,2023-03-22 00:22:54,2023-03-22,5774,23,5751,B59
94342,8208,0,2023-03-08 01:08:40,2023-03-08,1379,0,1379,A85
35757,8045,0,2023-03-18 10:48:48,2023-03-18,4103,39,4064,A89
42046,3108,0,2023-03-18 07:47:06,2023-03-18,550,27,523,A12
3727,7340,0,2023-03-19 07:07:04,2023-03-19,8999,32,8967,B60
20825,6725,0,2023-03-18 00:58:43,2023-03-18,9348,7,9341,A61
66795,3436,0,2023-03-14 01:23:59,2023-03-14,6378,97,6281,A60
72884,1766,0,2023-03-14 15:02:30,2023-03-14,1519,67,1452,A54
54323,4652,0,2023-03-13 20:37:22,2023-03-13,1817,80,1737,A41
42834,3576,0,2023-03-17 05:31:34,2023-03-17,8216,36,8180,A22
19218,9221,0,2023-02-28 03:04:36,2023-02-28,4280,67,4213,B74
36990,2237,0,2023-03-14 15:49:23,2023-03-14,7100,41,7059,B68
58691,1833,0,2023-03-14 09:41:20,2023-03-14,7920,30,7890,B26
31762,4617,0,2023-03-06 10:59:47,2023-03-06,548,55,493,A31
15086,9853,0,2023-03-03 10:13:40,2023-03-03,4877,22,4855,A86
64920,3153,0,2023-03-24 04:27:41,2023-03-24,2374,78,2296,A09
73424,2810,0,2023-03-17 03:16:23,2023-03-17,5325,12,5313,A70
5383,9817,0,2023-03-23 23:52:01,2023-03-23,3267,56,3211,A46
22194,6332,0,2023-02-28 06:53:44,2023-02-28,5104,48,5056,A17
50266,9302,0,2023-03-27 07:03:35,2023-03-27,194,25,169,A47
7545,9163,0,2023-03-15 03:28:07,2023-03-15,7215,84,7131,B75
76197,5777,0,2023-03-21 06:44:30,2023-03-21,3094,51,3043,A22
44280,8622,0,2023-03-14 10:30:07,2023-03-14,9610,56,9554,B57
71207,7152,0,2023-03-09 19:41:38,2023-03-09,482,98,384,A62
20696,6842,0,2023-03-21 08:36:18,2023-03-21,7309,68,7241,A79
33085,8527,0,2023-03-21 21:26:35,2023-03-21,3059,83,2976,B83
92455,6475,0,2023-03-22 13:07:32,2023-03-22,1105,47,1058,A90
10444,3445,0,2023-03-25 03:46:33,2023-03-25,3273,29,3244,B85
74139,2177,0,2023-03-15 20:41:03,2023-03-15,5937,49,5888,B27
60794,9786,0,2023-03-21 06:58:54,2023-03-21,8766,98,8668,A52
43231,3349,0,2023-03-10 03:02:03,2023-03-10,2017,1,2016,B78
70876,1135,0,2023-03-15 03:47:18,2023-03-15,7342,80,7262,A93
66518,7061,0,2023-03-13 15:42:09,2023-03-13,569,12,557,A56
89752,4056,0,2023-03-27 22:07:53,2023-03-27,4504,32,4472,A62
32148,3438,0,2023-03-02 20:28:38,2023-03-02,6179,2,6177,B87
16032,4187,0,2023-03-11 01:45:56,2023-03-11,9661,71,9590,A59
19346,8428,0,2023-03-05 06:31:02,2023-03-05,4888,72,4816,B83
53857,4075,0,2023-03-26 03:59:44,2023-03-26,7556,49,7507,B22
72383,4527,0,2023-03-15 05:42:19,2023-03-15,9242,52,9190,A50
41609,9128,0,2023-03-28 09:47:27,2023-03-28,267,34,233,A86
18890,5417,0,2023-03-05 01:18:09,2023-03-05,5506,28,5478,A02
49025,8536,0,2023-03-04 17:14:24,2023-03-04,7703,33,7670,B87
68395,3023,0,2023-03-04 22:36:33,2023-03-04,4179,37,4142,A61
49199,5298,0,2023-03-11 21:16:16,2023-03-11,3352,81,3271,A67
66920,7955,0,2023-03-10 07:32:11,2023-03-10,5565,33,5532,B26
60304,9854,0,2023-03-08 03:53:01,2023-03-08,2891,79,2812,B47
89149,1071,0,2023-03-02 16:43:32,2023-03-02,4141,19,4122,A16
98867,9364,0,2023-03-05 00:58:14,2023-03-05,3866,54,3812,B86
80971,6411,0,2023-03-13 14:02:26,2023-03-13,742,14,728,B79
61167,5792,0,2023-03-25 23:32:56,2023-03-25,4011,31,3980,A48
74333,1167,1,2023-02-28 11:01:15,2023-02-28,6174,60,6114,B67
28668,3410,0,2023-03-06 15:27:58,2023-03-06,7033,92,6941,B16
38600,9332,0,2023-03-29 08:39:29,2023-03-29,7138,98,7040,A17
78337,7377,0,2023-03-20 19:23:50,2023-03-20,4212,84,4128,A93
53478,2369,0,2023-03-03 11:22:28,2023-03-03,3384,1,3383,A14
91179,7152,0,2023-03-23 20:38:25,2023-03-23,7480,6,7474,B65
6964,1530,0,2023-03-16 16:16:20,2023-03-16,2517,31,2486,B16
81329,4278,0,2023-03-12 19:33:21,2023-03-12,9694,60,9634,B58
71447,1117,0,2023-03-22 10:58:06,2023-03-22,9813,72,9741,A85
94101,1607,0,2023-03-27 10:04:15,2023-03-27,366,99,267,B79
11917,7543,0,2023-03-02 00:21:17,2023-03-02,9034,14,9020,A21
96562,4469,0,2023-03-14 23:09:05,2023-03-14,4783,42,4741,A14
19961,2780,0,2023-03-01 13:41:55,2023-03-01,2756,34,2722,B76
70513,2696,0,2023-03-22 03:43:38,2023-03-22,2681,10,2671,A61
62442,2304,0,2023-03-13 01:11:07,2023-03-13,2128,38,2090,A82
62583,2659,0,2023-03-10 06:49:38,2023-03-10,9766,85,9681,B54
13891,5677,0,2023-03-14 21:29:05,2023-03-14,1307,30,1277,B76
86452,5584,0,2023-03-01 18:02:13,2023-03-01,3551,82,3469,A06
85480,4939,0,2023-03-07 17:52:08,2023-03-07,5344,28,5316,A73
48195,2165,0,2023-03-13 07:39:52,2023-03-13,6931,3,6928,A79
71021,1144,0,2023-03-12 11:04:23,2023-03-12,2931,57,2874,A10
55829,2812,0,2023-03-04 03:35:23,2023-03-04,338,73,265,B72
28872,2562,0,2023-03-29 16:19:38,2023-03-29,9689,50,9639,A31
59423,7904,0,2023-03-15 15:28:55,2023-03-15,7747,68,7679,A08
8446,4767,0,2023-03-16 14:36:16,2023-03-16,6011,86,5925,A10
98109,4549,0,2023-03-02 11:45:35,2023-03-02,7340,32,7308,B48
77359,6400,0,2023-03-21 01:28:52,2023-03-21,7624,52,7572,B81
83843,6762,0,2023-03-13 05:37:42,2023-03-13,2568,74,2494,A19
44206,5079,0,2023-02-28 11:26:49,2023-02-28,1455,67,1388,A47
94397,5237,0,2023-03-25 16:59:35,2023-03-25,8569,56,8513,B58
77473,9390,0,2023-03-07 04:00:28,2023-03-07,4466,39,4427,A55
20326,5313,0,2023-03-15 02:42:41,2023-03-15,2510,70,2440,A84
95773,2908,0,2023-03-16 00:43:50,2023-03-16,4836,6,4830,A42
33105,2395,0,2023-03-16 16:08:48,2023-03-16,7668,81,7587,B73
46162,9170,1,2023-03-07 01:09:05,2023-03-07,348,95,253,B11
16406,1096,0,2023-03-17 20:57:43,2023-03-17,3320,28,3292,A52
22710,6904,0,2023-03-20 01:39:48,2023-03-20,5017,90,4927,B73
70292,1233,0,2023-03-25 06:06:10,2023-03-25,4235,31,4204,A42
28447,2097,1,2023-03-21 16:59:26,2023-03-21,4755,73,4682,A72
51036,1483,0,2023-03-20 08:58:14,2023-03-20,9417,44,9373,A79
9527,8892,0,2023-03-23 06:54:12,2023-03-23,4913,45,4868,A28
58575,6639,0,2023-03-25 17:05:22,2023-03-25,748,87,661,B56
31416,2724,0,2023-03-11 01:03:13,2023-03-11,404,32,372,B67
88941,3246,0,2023-03-18 20:50:08,2023-03-18,5381,18,5363,A59
78652,1882,0,2023-03-03 00:32:49,2023-03-03,9505,12,9493,A88
41378,1883,0,2023-03-06 00:49:48,2023-03-06,5755,7,5748,A44
76418,4749,0,2023-03-13 12:39:10,2023-03-13,2099,24,2075,A56
52872,1095,0,2023-03-28 11:20:42,2023-03-28,1366,29,1337,B17
80771,2581,0,2023-03-07 09:32:22,2023-03-07,4400,70,4330,B27
63405,3351,0,2023-03-15 17:09:28,2023-03-15,9989,16,9973,A06
77904,3684,0,2023-03-09 05:16:51,2023-03-09,4758,45,4713,B71
29290,3260,0,2023-03-20 15:47:32,2023-03-20,1137,74,1063,B03
10048,2666,0,2023-03-26 23:03:48,2023-03-26,954,15,939,B09
48234,8114,1,2023-03-21 23:50:11,2023-03-21,6112,60,6052,B54
61688,9471,0,2023-03-18 05:07:24,2023-03-18,185,22,163,B88
64316,8455,0,2023-03-18 06:09:51,2023-03-18,6563,32,6531,B78
75428,5125,0,2023-03-26 07:41:50,2023-03-26,4696,17,4679,A25
20074,9322,1,2023-03-02 02:23:59,2023-03-02,3390,9,3381,A08
58127,5150,0,2023-03-28 04:00:22,2023-03-28,9520,12,9508,B81
39515,4183,0,2023-03-19 07:03:23,2023-03-19,6804,16,6788,A18
40951,4736,0,2023-03-06 05:04:58,2023-03-06,5680,37,5643,B46
59665,3541,0,2023-03-13 22:27:18,2023-03-13,8906,32,8874,B76
36622,6646,0,2023-03-20 21:12:39,2023-03-20,2962,94,2868,A08
1585,2984,0,2023-03-23 07:45:17,2023-03-23,3656,53,3603,B11
1032,4595,0,2023-03-14 03:51:37,2023-03-14,8863,61,8802,B70
83108,4761,0,2023-03-03 16:39:55,2023-03-03,4861,53,4808,B69
82402,3739,0,2023-03-19 19:12:26,2023-03-19,888,60,828,A31
80116,6918,0,2023-03-22 20:22:29,2023-03-22,7733,86,7647,B11
69533,7943,0,2023-03-08 00:16:46,2023-03-08,5033,50,4983,B60
8802,5714,0,2023-03-10 10:09:40,2023-03-10,1639,24,1615,B87
48619,4238,0,2023-03-25 10:33:03,2023-03-25,1059,96,963,A55
86646,8397,0,2023-03-10 04:07:07,2023-03-10,9651,66,9585,B10
19546,8544,0,2023-03-11 19:04:52,2023-03-11,4054,7,4047,A33
12187,7016,0,2023-03-13 10:45:58,2023-03-13,3723,72,3651,A31
52886,7867,0,2023-03-22 22:43:28,2023-03-22,1315,0,1315,A72
68939,9392,0,2023-03-20 14:28:58,2023-03-20,3727,26,3701,A57
22414,5815,0,2023-03-24 07:21:31,2023-03-24,5394,82,5312,B76
21362,1904,0,2023-02-28 20:02:19,2023-02-28,1772,10,1762,B15
230,3740,1,2023-03-02 07:45:39,2023-03-02,8035,85,7950,B22
30362,3466,0,2023-03-04 23:59:51,2023-03-04,1174,22,1152,B11
34950,3564,0,2023-03-20 18:00:21,2023-03-20,8186,23,8163,B45
95399,8793,0,2023-03-07 13:06:20,2023-03-07,6445,41,6404,A21
6857,4647,0,2023-03-01 01:57:39,2023-03-01,7230,88,7142,A67
61275,5222,0,2023-03-03 17:57:22,2023-03-03,5725,95,5630,B79
93419,4577,0,2023-03-27 21:41:05,2023-03-27,9432,7,9425,B50
49809,7378,0,2023-03-07 22:25:01,2023-03-07,2132,60,2072,B83
96954,4088,0,2023-03-29 10:29:50,2023-03-29,9561,41,9520,A21
24116,1351,0,2023-02-28 07:37:57,2023-02-28,9265,1,9264,A57
80689,1302,0,2023-03-11 22:47:26,2023-03-11,2800,76,2724,B71
63075,2431,0,2023-03-21 04:44:53,2023-03-21,6112,47,6065,A93
49447,5311,0,2023-03-02 08:38:04,2023-03-02,3125,57,3068,A08
67451,5106,0,2023-03-02 03:12:14,2023-03-02,443,74,369,B05
44234,7890,0,2023-03-25 13:21:20,2023-03-25,8074,87,7987,B51
10901,1006,0,2023-03-23 01:11:41,2023-03-23,9321,19,9302,B46
8303,3730,0,2023-03-11 12:04:32,2023-03-11,2958,15,2943,B86
84990,6768,0,2023-03-08 09:41:29,2023-03-08,2578,39,2539,A59
21940,3485,0,2023-03-13 06:55:39,2023-03-13,2410,90,2320,B64
22704,4074,0,2023-03-24 05:28:49,2023-03-24,9186,46,9140,A59
33156,4368,0,2023-03-18 19:40:46,2023-03-18,5555,0,5555,B11
34184,5434,0,2023-03-03 10:24:08,2023-03-03,5027,96,4931,A22
288,9021,0,2023-03-25 13:02:22,2023-03-25,9246,63,9183,B80
73182,9892,0,2023-03-03 17:42:47,2023-03-03,6546,46,6500,A46
55707,7600,0,2023-03-13 15:33:07,2023-03-13,4413,42,4371,A46
90452,4427,0,2023-03-03 12:14:52,2023-03-03,208,7,201,B42
93463,6275,0,2023-03-13 11:41:10,2023-03-13,992,21,971,A92
9685,9557,0,2023-03-09 23:21:21,2023-03-09,4319,15,4304,A76
93457,2152,0,2023-03-19 19:28:18,2023-03-19,3847,69,3778,B78
81789,2574,0,2023-03-17 16:13:00,2023-03-17,8926,25,8901,A73
37842,1526,0,2023-03-26 08:04:43,2023-03-26,3047,13,3034,A34
54715,9622,0,2023-03-24 11:50:34,2023-03-24,2968,94,2874,B58
31753,1603,0,2023-03-02 05:07:18,2023-03-02,1236,45,1191,B02
63132,5544,0,2023-03-10 01:27:30,2023-03-10,9283,30,9253,B32
71669,3120,0,2023-03-13 08:38:23,2023-03-13,3019,69,2950,B10
9832,1337,0,2023-03-11 14:11:09,2023-03-11,5065,68,4997,B08
1078,1571,0,2023-03-19 20:55:49,2023-03-19,7254,35,7219,B44
89356,3348,0,2023-03-12 16:35:10,2023-03-12,3692,19,3673,B90
64490,4452,0,2023-02-27 21:14:34,2023-02-27,6914,92,6822,B18
86373,9744,0,2023-03-16 18:10:34,2023-03-16,475,13,462,B71
612,7345,0,2023-03-24 15:17:18,2023-03-24,4305,84,4221,A27
84597,4413,0,2023-03-08 01:07:55,2023-03-08,9041,40,9001,A15
49498,1881,0,2023-03-04 19:36:06,2023-03-04,6528,80,6448,B17
6248,6409,0,2023-03-22 00:58:29,2023-03-22,3513,31,3482,A06
52570,7402,0,2023-03-09 09:16:29,2023-03-09,1198,10,1188,B64
65693,7512,0,2023-03-26 09:14:59,2023-03-26,6121,55,6066,A31
329,1249,0,2023-03-07 11:37:42,2023-03-07,6429,68,6361,A33
90394,5597,0,2023-03-25 17:12:39,2023-03-25,9032,80,8952,B08
60091,4393,0,2023-03-18 17:22:54,2023-03-18,1968,78,1890,B46
63562,5244,0,2023-03-24 08:20:10,2023-03-24,2211,40,2171,A19
50554,3451,0,2023-03-12 18:01:50,2023-03-12,2000,85,1915,A51
76574,8476,0,2023-03-26 14:09:56,2023-03-26,6767,82,6685,B04
18134,9776,0,2023-03-08 14:37:58,2023-03-08,703,55,648,A26
31437,3573,0,2023-02-28 02:43:47,2023-02-28,8163,85,8078,A14
56455,5658,0,2023-03-16 20:05:10,2023-03-16,8221,31,8190,B82
14777,1533,0,2023-03-20 22:34:56,2023-03-20,3360,98,3262,B48
85246,1581,0,2023-03-21 09:25:07,2023-03-21,9200,88,9112,B68
9893,9766,0,2023-03-05 22:50:09,2023-03-05,4436,4,4432,B86
92122,6851,0,2023-03-18 21:48:21,2023-03-18,8757,61,8696,A56
6211,7435,0,2023-03-17 16:45:58,2023-03-17,6104,96,6008,A02
49002,6365,0,2023-03-05 23:12:00,2023-03-05,1209,94,1115,A69
2109,7350,0,2023-03-16 07:53:37,2023-03-16,3572,82,3490,B03
9837,6098,1,2023-03-18 23:53:15,2023-03-18,6683,72,6611,A33
4565,5668,0,2023-03-19 09:43:07,2023-03-19,4529,34,4495,A88
52738,9141,0,2023-03-06 22:15:21,2023-03-06,833,63,770,A15
56104,9054,0,2023-03-17 20:40:18,2023-03-17,6196,25,6171,A50
31325,2543,0,2023-02-28 09:58:14,2023-02-28,2124,30,2094,B44
49740,6660,0,2023-03-06 13:54:37,2023-03-06,7423,57,7366,A41
77846,3678,0,2023-03-10 15:32:49,2023-03-10,993,77,916,B11
38972,7126,0,2023-03-02 00:42:24,2023-03-02,8176,35,8141,A81
12114,6581,0,2023-03-04 15:41:27,2023-03-04,1302,86,1216,A09
87287,3249,0,2023-03-28 13:20:45,2023-03-28,8183,63,8120,B85
33877,5637,0,2023-03-22 21:00:22,2023-03-22,4775,46,4729,A90
3074,3433,0,2023-03-25 23:08:03,2023-03-25,1403,36,1367,B02
99268,8737,0,2023-03-26 13:28:59,2023-03-26,3786,77,3709,B51
27078,1094,0,2023-03-19 08:44:01,2023-03-19,1876,34,1842,B86
54214,3646,0,2023-03-14 17:19:07,2023-03-14,1567,80,1487,A69
46547,1356,0,2023-03-21 19:33:25,2023-03-21,4481,68,4413,A67
25892,2117,0,2023-03-20 12:56:11,2023-03-20,103,97,6,A59
45367,9806,0,2023-03-14 22:10:40,2023-03-14,3446,20,3426,B07
59030,8943,1,2023-03-04 21:52:10,2023-03-04,668,69,599,A13
23506,7361,0,2023-03-26 11:07:13,2023-03-26,2191,41,2150,A18
27867,6861,0,2023-03-01 22:22:05,2023-03-01,4578,77,4501,B32
20771,8000,0,2023-03-08 20:15:38,2023-03-08,1777,81,1696,A62
9098,1253,0,2023-02-28 11:26:50,2023-02-28,4883,71,4812,A92
64899,5033,0,2023-03-26 22:17:55,2023-03-26,2766,86,2680,A80
57664,6254,0,2023-03-07 19:59:17,2023-03-07,2171,85,2086,B53
90164,5949,0,2023-03-24 19:48:07,2023-03-24,6314,59,6255,A93
53682,9035,0,2023-03-15 20:20:02,2023-03-15,220,30,190,A25
37331,1480,0,2023-03-18 00:21:53,2023-03-18,6828,84,6744,B07
3670,8608,0,2023-03-15 01:48:50,2023-03-15,6959,64,6895,B46
70860,8529,0,2023-03-11 23:45:13,2023-03-11,8631,87,8544,A10
31636,4832,0,2023-03-21 12:51:08,2023-03-21,4473,84,4389,B60
88661,5917,0,2023-03-22 13:57:31,2023-03-22,6436,49,6387,A46
65099,4346,0,2023-03-11 10:06:22,2023-03-11,7405,3,7402,B55
29091,9961,0,2023-03-18 16:35:45,2023-03-18,6798,72,6726,A68
6222,3450,0,2023-03-15 19:37:34,2023-03-15,9574,66,9508,B47
40320,8307,0,2023-03-25 07:14:15,2023-03-25,7979,84,7895,A59
81122,2861,0,2023-03-24 08:27:04,2023-03-24,1199,92,1107,A14
25941,7830,0,2023-03-16 05:20:16,2023-03-16,4648,18,4630,A61
8319,4728,0,2023-03-13 07:18:26,2023-03-13,5328,64,5264,B84
13175,3815,1,2023-03-01 04:14:03,2023-03-01,9864,8,9856,B78
76475,7286,0,2023-03-03 00:43:07,2023-03-03,6961,2,6959,B66
7804,2228,0,2023-03-23 16:25:37,2023-03-23,9959,75,9884,A25
97046,5758,0,2023-03-19 06:01:48,2023-03-19,2963,60,2903,B64
42738,3845,0,2023-03-05 09:53:01,2023-03-05,6291,19,6272,A21
55169,6368,0,2023-03-01 11:01:05,2023-03-01,2546,57,2489,B78
91890,9140,0,2023-03-28 16:55:52,2023-03-28,4626,93,4533,B70
80408,6022,0,2023-03-07 05:22:45,2023-03-07,7339,5,7334,A39
13428,1416,0,2023-03-14 18:34:52,2023-03-14,2939,60,2879,A73
20170,3935,0,2023-03-24 18:51:26,2023-03-24,4921,36,4885,B24
46030,7223,0,2023-03-21 17:18:56,2023-03-21,1430,97,1333,B61
97639,2543,0,2023-03-23 19:27:59,2023-03-23,2662,72,2590,A93
58070,1458,0,2023-03-16 20:21:13,2023-03-16,4085,39,4046,A11
7978,9086,0,2023-03-11 17:23:57,2023-03-11,9439,87,9352,B12
29338,3665,0,2023-03-20 14:11:14,2023-03-20,7814,83,7731,B83
61741,5153,0,2023-03-25 20:27:09,2023-03-25,631,22,609,A36
38204,5252,0,2023-03-14 10:26:10,2023-03-14,4321,15,4306,B71
56425,3882,0,2023-03-08 16:59:24,2023-03-08,4943,10,4933,B21
28520,2969,0,2023-03-21 22:36:34,2023-03-21,3247,60,3187,A11
88943,5854,0,2023-03-11 17:49:20,2023-03-11,9845,78,9767,A54
51716,4110,0,2023-03-16 08:51:34,2023-03-16,5481,71,5410,B82
16426,6667,0,2023-03-23 08:06:52,2023-03-23,9286,6,9280,A99
44952,2265,0,2023-03-17 22:23:36,2023-03-17,8971,15,8956,B50
33454,5505,0,2023-03-02 11:50:37,2023-03-02,5647,98,5549,B76
42040,1157,0,2023-03-26 13:05:16,2023-03-26,9572,35,9537,B49
71409,2218,0,2023-03-08 17:44:57,2023-03-08,1461,93,1368,B08
44282,4494,0,2023-03-13 14:28:28,2023-03-13,4378,9,4369,A18
29227,1259,0,2023-03-25 07:31:10,2023-03-25,5805,81,5724,B45
62169,4421,0,2023-03-01 16:40:23,2023-03-01,735,73,662,A42
58598,9544,0,2023-03-08 10:47:50,2023-03-08,7484,75,7409,B58
28922,3630,0,2023-03-07 23:13:18,2023-03-07,3078,7,3071,B88
25156,5977,0,2023-03-12 02:41:14,2023-03-12,9383,62,9321,A88
1642,2884,0,2023-03-16 13:52:17,2023-03-16,835,46,789,A68
75549,3565,0,2023-03-17 18:31:26,2023-03-17,5575,66,5509,B81
78118,3074,0,2023-03-14 10:29:32,2023-03-14,3814,73,3741,B17
54786,8358,0,2023-03-06 15:15:36,2023-03-06,5566,93,5473,A18
22591,4589,0,2023-03-19 13:30:53,2023-03-19,8472,32,8440,A31
76864,4781,0,2023-03-01 23:15:00,2023-03-01,5809,2,5807,B45
39553,5888,0,2023-03-25 04:26:32,2023-03-25,8234,69,8165,B05
61756,5502,0,2023-03-12 22:39:31,2023-03-12,3468,93,3375,B48
45597,5764,0,2023-03-26 14:15:40,2023-03-26,5508,69,5439,A26
74257,2464,0,2023-03-09 06:24:30,2023-03-09,1701,83,1618,A87
48711,8199,0,2023-03-03 00:37:02,2023-03-03,6345,99,6246,B88
50424,3512,0,2023-02-28 00:14:00,2023-02-28,5903,48,5855,A33
24857,6449,0,2023-03-27 07:09:47,2023-03-27,4970,85,4885,A26
95571,1565,0,2023-03-26 09:12:07,2023-03-26,2082,82,2000,B44
69803,2781,0,2023-03-05 16:47:02,2023-03-05,4002,74,3928,A63
49825,3417,0,2023-03-06 21:48:11,2023-03-06,8843,98,8745,B07
14359,3128,0,2023-02-28 17:33:43,2023-02-28,7513,46,7467,B07
91260,7831,0,2023-03-24 07:02:09,2023-03-24,8829,56,8773,B82
97884,2957,0,2023-03-09 09:33:14,2023-03-09,2746,18,2728,A40
38493,2252,0,2023-03-17 03:11:37,2023-03-17,9128,86,9042,A46
46019,9655,0,2023-03-03 08:15:22,2023-03-03,1549,72,1477,A27
86337,3880,0,2023-03-03 14:21:22,2023-03-03,8375,21,8354,B50
15598,6122,0,2023-03-18 16:49:38,2023-03-18,6288,35,6253,A55
80882,1127,0,2023-03-22 11:10:29,2023-03-22,5435,80,5355,B54
55882,7960,0,2023-03-01 17:53:57,2023-03-01,4376,93,4283,A47
70080,5919,0,2023-02-28 20:02:52,2023-02-28,5186,40,5146,B31
72619,5384,0,2023-03-17 19:33:22,2023-03-17,3011,39,2972,A32
42021,6009,0,2023-03-10 07:05:29,2023-03-10,9074,27,9047,A90
31547,3820,0,2023-03-28 05:31:31,2023-03-28,8304,6,8298,B57
43757,1607,0,2023-03-05 04:25:21,2023-03-05,9867,20,9847,A06
38649,8607,0,2023-03-21 17:29:31,2023-03-21,6499,86,6413,B42
89828,1429,0,2023-03-12 11:42:10,2023-03-12,7427,71,7356,B14
31773,7161,0,2023-03-05 21:17:34,2023-03-05,3717,77,3640,A65
19208,9132,0,2023-03-02 22:46:45,2023-03-02,3702,66,3636,A33
69926,3928,0,2023-03-09 10:31:05,2023-03-09,5245,21,5224,A13
12294,9390,0,2023-03-25 08:38:30,2023-03-25,9325,70,9255,B09
7270,3506,0,2023-03-13 22:14:35,2023-03-13,5864,91,5773,A40
44097,8276,0,2023-03-16 22:39:26,2023-03-16,3822,87,3735,B32
27478,8985,0,2023-03-27 08:23:05,2023-03-27,9396,10,9386,A44
73309,8748,0,2023-03-12 04:53:24,2023-03-12,5990,40,5950,A87
99259,1461,0,2023-03-14 16:07:06,2023-03-14,2797,26,2771,A15
44808,4751,0,2023-03-25 14:38:41,2023-03-25,9895,15,9880,A68
62122,2109,0,2023-03-15 03:36:37,2023-03-15,492,52,440,B05
55521,5220,1,2023-02-28 16:27:32,2023-02-28,8294,11,8283,A25
76426,9604,1,2023-03-02 23:06:17,2023-03-02,6130,92,6038,A86
29173,8237,0,2023-03-20 22:28:42,2023-03-20,5366,85,5281,A84
51917,6153,0,2023-03-02 15:19:02,2023-03-02,6001,11,5990,A13
88533,5802,0,2023-03-29 01:18:44,2023-03-29,4711,100,4611,B90
59593,3885,0,2023-03-06 09:55:32,2023-03-06,846,30,816,A03
69201,8302,0,2023-03-20 09:50:33,2023-03-20,9386,38,9348,B78
21377,3194,0,2023-03-21 23:46:16,2023-03-21,1106,4,1102,A65
23968,4114,0,2023-03-10 10:59:23,2023-03-10,4854,59,4795,B81
86155,9802,0,2023-03-09 07:18:46,2023-03-09,6450,73,6377,A70
40467,9725,0,2023-03-18 23:30:42,2023-03-18,1376,24,1352,A25
74915,7089,0,2023-03-07 23:56:13,2023-03-07,8056,14,8042,B83
36883,2292,0,2023-03-16 23:47:13,2023-03-16,924,80,844,B21
96056,8889,0,2023-03-24 16:02:35,2023-03-24,8936,72,8864,A85
22099,6713,0,2023-03-08 05:08:14,2023-03-08,8477,13,8464,B46
14297,5829,0,2023-03-08 18:08:15,2023-03-08,4641,78,4563,B88
68096,4846,0,2023-03-02 22:59:59,2023-03-02,3140,70,3070,B56
2792,6181,0,2023-03-06 13:35:42,2023-03-06,3467,54,3413,A85
90673,6263,0,2023-03-02 13:20:23,2023-03-02,2754,16,2738,A60
35361,8905,0,2023-03-10 08:54:39,2023-03-10,2982,73,2909,B07
26667,9960,0,2023-03-25 18:39:00,2023-03-25,6866,65,6801,A73
10151,8484,0,2023-03-03 09:02:23,2023-03-03,3013,87,2926,A65
46369,7300,0,2023-03-11 07:39:13,2023-03-11,7551,7,7544,B47
9771,2927,0,2023-03-23 18:47:53,2023-03-23,8227,2,8225,A50
16630,1748,0,2023-03-01 00:30:38,2023-03-01,8981,9,8972,A63
47463,6197,0,2023-03-23 11:00:09,2023-03-23,1489,9,1480,A84
3281,7468,0,2023-03-17 13:10:26,2023-03-17,3856,71,3785,B12
86309,9704,0,2023-03-17 15:44:32,2023-03-17,3290,27,3263,A62
3365,9217,0,2023-03-14 08:34:05,2023-03-14,9238,19,9219,B18
